entity_id	valid	rejected	polled	electors	UNP	SLFP	SLMP	__OTHER
EC-01	735315	11295	746610	1105583	361337	339958	34020	0
EC-01A	35392	647	36039	54149	22389	10744	2259	0
EC-01B	89399	1572	90971	133920	58795	26083	4521	0
EC-01C	31237	499	31736	47917	16452	13083	1702	0
EC-01D	32255	666	32921	51225	16480	13477	2298	0
EC-01E	23523	342	23865	37220	14670	7473	1380	0
EC-01F	36632	520	37152	52969	18326	16599	1707	0
EC-01G	38500	584	39084	55248	18409	18308	1783	0
EC-01H	51356	849	52205	75650	23895	25050	2411	0
EC-01I	43604	563	44167	67194	18834	22607	2163	0
EC-01J	55580	806	56386	87693	22872	30600	2108	0
EC-01K	49212	570	49782	68892	24292	23721	1199	0
EC-01L	50110	679	50789	86987	20810	27570	1730	0
EC-01M	54426	779	55205	83598	20770	31396	2260	0
EC-01N	62961	879	63840	89277	25549	35184	2228	0
EC-01O	64688	977	65665	96841	31546	29654	3488	0
EC-01P	16440	363	16803	16803	7248	8409	783	0
EC-02	728112	10108	738220	985206	350092	355553	22467	0
EC-02A	49207	666	49873	68477	27945	19361	1901	0
EC-02B	47337	587	47924	68250	29016	16601	1720	0
EC-02C	56175	822	56997	76452	28760	25379	2036	0
EC-02D	52704	742	53446	68377	25792	25857	1055	0
EC-02E	55621	860	56481	78953	26835	27712	1074	0
EC-02F	60579	825	61404	78056	29424	29751	1404	0
EC-02G	59475	735	60210	79172	22242	35758	1475	0
EC-02H	62127	721	62848	85424	25948	34340	1839	0
EC-02I	57144	1052	58196	81566	30021	25357	1766	0
EC-02J	58736	735	59471	79936	26024	30305	2407	0
EC-02K	57960	511	58471	72945	26155	30829	976	0
EC-02L	49081	685	49766	66166	23930	23633	1518	0
EC-02M	46972	690	47662	65961	21395	22877	2700	0
EC-02P	14994	477	15471	15471	6605	7793	596	0
EC-03	362646	6537	369183	575008	169510	179761	13375	0
EC-03A	54615	799	55414	78330	22701	28366	3548	0
EC-03B	55224	871	56095	73585	26066	26897	2261	0
EC-03C	49323	632	49955	69405	23868	24116	1339	0
EC-03D	37939	880	38819	58030	18705	18491	743	0
EC-03E	38661	716	39377	70457	17917	19908	836	0
EC-03F	47535	1161	48696	75912	22551	22425	2559	0
EC-03G	43401	700	44101	73408	20529	21920	952	0
EC-03H	31315	521	31836	70991	15155	15255	905	0
EC-03P	4633	257	4890	4890	2018	2383	232	0
EC-04	426577	6167	432744	633030	234124	186187	6266	0
EC-04A	27950	263	28213	39671	15071	12549	330	0
EC-04B	57021	962	57983	94109	30708	25594	719	0
EC-04C	36546	611	37157	48741	20902	15087	557	0
EC-04D	24822	386	25208	37345	12032	12466	324	0
EC-04E	19576	339	19915	27659	9912	9417	247	0
EC-04F	27782	407	28189	48841	15231	12118	433	0
EC-04G	34001	373	34374	42868	19688	14015	298	0
EC-04H	32349	395	32744	48208	16825	14690	834	0
EC-04I	18877	297	19174	28958	11301	6959	617	0
EC-04J	30692	362	31054	52182	14478	15699	515	0
EC-04K	27317	550	27867	50223	16582	10420	315	0
EC-04L	44194	517	44711	55425	24800	18976	418	0
EC-04M	40844	521	41365	54010	24203	16082	559	0
EC-04P	4606	184	4790	4790	2391	2115	100	0
EC-05	63967	1110	65077	215999	37007	25825	1135	0
EC-05A	7608	102	7710	72515	4276	3195	137	0
EC-05B	18179	198	18377	41110	9055	8908	216	0
EC-05C	19870	463	20333	48841	12544	6889	437	0
EC-05D	17299	297	17596	52472	10599	6380	320	0
EC-05P	1011	50	1061	1061	533	453	25	0
EC-06	180413	3320	183733	231278	112135	64907	3371	0
EC-06A	77152	1771	78923	101765	52653	22209	2290	0
EC-06B	31643	401	32044	39194	17822	13549	272	0
EC-06C	37129	576	37705	44596	22748	14011	370	0
EC-06D	33022	530	33552	44214	18099	14519	404	0
EC-06P	1467	42	1509	1509	813	619	35	0
EC-07	279944	4461	284405	576390	124912	148615	6417	0
EC-07A	8922	162	9084	41220	5093	3475	354	0
EC-07B	6960	150	7110	49885	3282	3444	234	0
EC-07C	10102	151	10253	47887	4210	5703	189	0
EC-07D	21327	299	21626	65597	8789	12057	481	0
EC-07E	45170	745	45915	65310	22029	22347	794	0
EC-07F	48370	793	49163	65351	20368	27061	941	0
EC-07G	25872	456	26328	60877	11539	13290	1043	0
EC-07H	37528	633	38161	56083	19227	17432	869	0
EC-07I	40406	368	40774	57724	16865	22877	664	0
EC-07J	30466	438	30904	61369	11500	18329	637	0
EC-07P	4821	266	5087	5087	2010	2600	211	0
EC-08	105745	2003	107748	452637	45399	57424	2922	0
EC-08A	21660	378	22038	58342	10157	10949	554	0
EC-08B	2862	51	2913	65407	1327	1494	41	0
EC-08C	9163	277	9440	67076	5346	3505	312	0
EC-08D	4650	89	4739	63590	1256	3228	166	0
EC-08E	9667	104	9771	62490	5076	4403	188	0
EC-08F	30422	497	30919	64438	11606	17718	1098	0
EC-08G	26685	540	27225	70591	10351	15802	532	0
EC-08P	636	67	703	703	280	325	31	0
EC-09	83019	3855	86874	295536	41198	39343	2478	0
EC-09A	12074	663	12737	66740	5952	5740	382	0
EC-09B	12852	491	13343	62773	6793	5733	326	0
EC-09C	16887	1007	17894	70422	8292	8026	569	0
EC-09D	40877	1667	42544	95245	20020	19665	1192	0
EC-09P	329	27	356	356	141	179	9	0
EC-10	120045	8517	128562	551713	33650	44197	42198	0
EC-10A	12395	596	12991	49481	4628	3264	4503	0
EC-10B	16056	2397	18453	18453	4309	6495	5252	0
EC-10C	9321	451	9772	60386	2364	3117	3840	0
EC-10D	12586	891	13477	58320	4006	3491	5089	0
EC-10E	12651	733	13384	56450	2493	5833	4325	0
EC-10F	8182	303	8485	52084	1662	3400	3120	0
EC-10G	9451	772	10223	40175	2620	3921	2910	0
EC-10H	10027	1035	11062	51595	2300	3704	4023	0
EC-10I	8286	482	8768	61936	2000	3362	2924	0
EC-10J	10637	479	11116	49229	3475	3546	3616	0
EC-10K	10453	378	10831	53604	3793	4064	2596	0
EC-11	18969	708	19677	95061	10580	4889	3500	0
EC-11A	6966	149	7115	47060	4500	1431	1035	0
EC-11B	6147	230	6377	6377	2982	1819	1346	0
EC-11C	5856	329	6185	41624	3098	1639	1119	0
EC-12	120918	5163	126081	215983	61657	21018	38243	0
EC-12A	32799	1079	33878	59421	15289	8375	9135	0
EC-12B	53495	1702	55197	99717	29976	8547	14972	0
EC-12C	34235	2373	36608	56447	16227	4031	13977	0
EC-12P	389	9	398	398	165	65	159	0
EC-13	189909	3802	193711	266396	96420	83137	10352	0
EC-13A	68005	831	68836	94068	34251	32915	839	0
EC-13B	33227	857	34084	44790	17866	12983	2378	0
EC-13C	30220	573	30793	44077	18746	9708	1766	0
EC-13D	57846	1524	59370	82833	25262	27239	5345	0
EC-13P	611	17	628	628	295	292	24	0
EC-14	80620	1326	81949	152540	36841	29679	14103	0
EC-14A	25841	404	26245	47693	12319	12733	789	0
EC-14B	22257	565	22822	56026	8112	5767	8378	0
EC-14C	32276	352	32631	48570	16283	11087	4909	0
EC-14P	246	5	251	251	127	92	27	0
EC-15	388599	4281	392880	734453	198662	182220	7717	0
EC-15A	27367	366	27733	60948	12687	13705	975	0
EC-15B	21988	235	22223	56592	11988	9536	464	0
EC-15C	15993	207	16200	16200	7250	7950	793	0
EC-15D	20783	214	20997	59781	12154	8193	436	0
EC-15E	20605	181	20786	48131	10150	10208	247	0
EC-15F	24308	259	24567	48087	11747	12131	430	0
EC-15G	38625	336	38961	55318	18932	19275	418	0
EC-15H	29317	389	29706	61644	15140	13662	515	0
EC-15I	36218	338	36556	62275	18063	17660	495	0
EC-15J	38364	430	38794	63877	21532	16301	531	0
EC-15K	30315	375	30690	51363	13915	15872	528	0
EC-15L	25990	300	26290	53193	13598	11851	541	0
EC-15M	38451	380	38831	52815	20429	17465	557	0
EC-15N	20275	271	20546	44229	11077	8411	787	0
EC-16	224255	2965	227220	321387	125339	94823	4093	0
EC-16A	37790	632	38422	57106	24362	12613	815	0
EC-16B	40789	393	41182	67553	21252	18875	662	0
EC-16C	52165	731	52896	70574	27932	23485	748	0
EC-16D	41630	388	42018	57526	22194	18585	851	0
EC-16E	49582	736	50318	66244	28407	20234	941	0
EC-16P	2299	85	2384	2384	1192	1031	76	0
EC-17	132634	2207	134841	335551	56951	73154	2529	0
EC-17A	21280	459	21739	47805	8367	12542	371	0
EC-17B	11173	244	11417	42773	4023	7038	112	0
EC-17C	22443	371	22814	50340	10310	11516	617	0
EC-17D	30806	428	31234	52547	14857	15492	457	0
EC-17E	24195	365	24560	65945	8947	14637	611	0
EC-17F	8183	211	8394	33651	4027	4018	138	0
EC-17G	13077	129	13206	41013	5683	7203	191	0
EC-17P	1477	0	1477	1477	737	708	32	0
EC-18	47522	1157	48679	164213	26392	20173	957	0
EC-18A	4681	44	4725	50128	2433	2123	125	0
EC-18B	10250	448	10698	48728	6592	3497	161	0
EC-18C	32150	634	32784	64885	17179	14320	651	0
EC-18P	441	31	472	472	188	233	20	0
EC-19	134424	3276	137700	311473	80779	50223	3422	0
EC-19A	25171	435	25606	46724	16990	7682	499	0
EC-19B	12186	285	12471	12471	6397	5575	214	0
EC-19C	10786	425	11211	31509	7056	3500	230	0
EC-19D	8592	185	8777	31924	4968	3160	464	0
EC-19E	17133	466	17599	35367	10005	6585	543	0
EC-19F	4263	130	4393	38520	3255	956	52	0
EC-19G	11303	232	11535	41846	7491	3580	232	0
EC-19H	26149	717	26866	42467	14191	11182	776	0
EC-19I	18841	401	19242	30645	10426	8003	412	0
EC-20	26692	851	27543	162135	16872	9123	697	0
EC-20A	14969	507	15476	43093	9091	5507	371	0
EC-20B	3257	116	3373	51823	1781	1366	110	0
EC-20C	8295	191	8486	67011	5895	2188	212	0
EC-20P	171	37	208	208	105	62	4	0
EC-21	349017	4113	353130	460735	180622	159879	8516	0
EC-21A	44965	533	45498	61203	24281	18647	2037	0
EC-21B	55147	608	55755	70048	26029	27658	1460	0
EC-21C	35740	400	36140	43820	18370	16719	651	0
EC-21D	47647	516	48163	59661	24802	22074	771	0
EC-21E	45995	538	46533	58565	26643	18744	608	0
EC-21F	45372	467	45839	54001	23198	21298	876	0
EC-21G	28490	369	28859	36544	14316	12994	1180	0
EC-21H	42217	615	42832	73382	21204	20184	829	0
EC-21P	3444	67	3511	3511	1779	1561	104	0
EC-22	295412	4277	299689	440836	168720	119769	6923	0
EC-22A	36584	396	36980	61669	20951	15046	587	0
EC-22B	31472	570	32042	48269	16732	14160	580	0
EC-22C	31087	474	31561	48217	15167	15226	694	0
EC-22D	29058	411	29469	43847	16033	12490	535	0
EC-22E	37052	452	37504	55270	22423	14094	535	0
EC-22F	24834	369	25203	37459	14894	9605	335	0
EC-22G	36319	516	36835	48662	21614	13452	1253	0
EC-22H	36205	542	36747	50045	21282	13249	1674	0
EC-22I	29252	438	29690	43740	17649	11008	595	0
EC-22P	3549	109	3658	3658	1975	1439	135	0
LK	5094754	91499	5186256	9283143	2569199	2289857	235701	0